20 50 0 19 19 48 3
75 75 75 75 75 50 50 50 50 50 50 50 50 50 50 50 50 50 50 50 50 50 50 50 50 75 75 75 75 75 75 75 100 100 100 100 100 100 0 0 0 100 100 100 100 100 100 100 100
75 75 75 75 75 75 75 50 50 50 50 50 50 50 50 50 50 50 50 50 50 50 50 50 50 75 75 75 75 75 75 75 100 100 100 100 100 100 0 0 0 0 0 100 100 100 100 100 100 100
100 75 75 75 75 75 75 75 75 50 50 50 50 50 50 50 50 50 50 50 50 50 50 50 75 75 75 75 75 75 75 75 100 100 100 100 100 100 0 0 0 0 0 0 0 100 100 100 100 100 100
100 100 75 75 75 75 75 75 75 75 75 50 50 50 50 50 50 50 50 50 50 50 50 50 50 75 75 75 75 75 75 100 100 100 100 100 100 100 100 0 0 0 0 0 0 0 100 100 100 100 100 100
100 100 100 75 75 75 75 75 75 75 75 75 50 50 50 50 50 50 50 50 50 50 50 50 50 75 75 75 75 100 100 100 100 100 100 100 100 100 100 0 0 0 0 0 0 0 100 100 100 100
100 100 100 100 75 75 75 75 75 75 75 75 75 50 50 50 50 50 50 50 50 50 50 50 50 50 50 75 75 75 100 100 100 100 100 100 100 100 100 100 100 0 0 0 0 100 100 100 100 100 100
100 100 100 100 100 75 75 75 75 75 75 75 75 75 50 50 50 50 50 50 50 50 50 50 50 50 50 75 75 75 100 100 100 100 100 100 100 100 100 0 0 0 0 100 100 100 100 100 100 100
0 0 100 100 100 100 100 75 75 75 75 75 75 75 75 50 50 50 50 50 50 50 50 50 50 50 50 75 75 75 100 100 100 100 100 100 100 0 0 0 100 100 100 100 100 100 100 100 100
0 0 0 0 100 100 100 100 100 75 75 75 75 75 75 75 50 50 50 50 50 50 50 50 50 50 50 75 75 75 100 100 100 100 100 100 100 100 100 100 100 100 100 100 100 100 100 100 100 100
0 0 0 0 0 100 100 100 100 100 75 75 75 75 75 50 50 50 50 50 50 50 50 50 50 50 75 75 75 75 100 100 100 100 100 100 100 100 100 100 100 100 100 100 100 100 100 100 100 100
0 0 0 0 100 100 100 100 100 75 75 75 75 75 50 50 50 50 50 50 50 50 50 50 50 75 75 75 75 75 100 100 100 100 100 100 100 100 100 100 100 100 100 100 100 100 100 100 100 100
0 0 0 100 100 100 100 100 75 75 75 75 75 50 50 50 50 50 50 50 50 50 50 50 75 75 75 75 75 75 75 75 100 100 100 100 100 100 100 100 100 100 100 100 100 100 100 100 100 0
0 0 100 100 100 100 100 75 75 75 75 75 50 50 50 50 50 50 50 50 50 50 50 75 75 75 75 75 75 75 75 75 75 75 100 100 100 100 100 100 100 100 100 100 100 100 100 100 0 0
0 100 100 100 100 75 75 75 75 75 75 50 50 50 50 50 50 50 50 50 50 50 75 75 75 75 75 75 75 75 75 75 75 75 75 100 100 100 100 100 100 100 100 100 100 100 100 0 0 0
100 100 100 100 75 75 75 75 75 75 50 50 50 50 50 50 50 50 50 50 50 50 75 75 75 75 75 75 75 75 75 75 75 75 75 100 100 100 100 100 100 100 100 100 100 100 100 0 0 0
100 100 100 75 75 75 75 75 50 50 50 50 50 50 50 50 50 50 50 50 50 75 75 75 75 75 75 75 75 75 75 75 75 100 100 100 100 100 100 100 100 100 100 100 100 0 0 0 0 0
100 100 75 75 75 75 75 50 50 50 50 50 50 50 50 50 50 50 50 50 50 75 75 75 75 75 75 75 75 75 75 100 100 100 100 100 100 100 100 100 100 100 0 0 0 0 0 0 0 0
100 75 75 75 75 75 50 50 50 50 50 50 50 50 50 50 50 50 50 50 75 75 75 75 75 75 75 75 75 75 75 75 75 100 100 100 100 100 100 100 100 0 0 0 0 0 0 0 0 0 0
75 75 75 75 75 50 50 50 50 50 50 50 50 50 50 50 50 50 50 75 75 75 75 75 75 75 75 75 75 75 75 100 100 100 100 100 100 100 100 0 0 0 0 0 0 0 0 0 0 0 0
75 75 75 75 50 50 50 50 50 50 50 50 50 50 50 50 50 50 50 75 75 75 75 75 75 75 75 75 75 100 100 100 100 100 100 100 100 0 0 0 0 0 0 0 0 0 0 0 0 0
