15 50 0 15 50 1 10
0 0 0 0 50 75 50 50 50 50 50 50 75 75 75 75 75 75 75 75 75 75 75 50 50 50 50 75 75 100 100 100 100 100 100 100 75 50 50 50 50 50 75 100 100 100 100 75 50 50
0 0 50 50 75 100 75 50 50 50 50 75 75 0 0 0 0 0 0 0 0 75 75 75 50 50 50 75 75 100 100 100 100 100 75 75 50 50 50 50 50 75 75 75 75 75 75 50 50 75
0 50 75 75 100 100 50 75 0 75 50 50 75 0 0 0 0 0 75 75 75 50 50 50 50 50 50 75 75 100 100 100 100 75 75 50 50 50 50 100 100 100 100 75 75 75 50 50 50 75
50 75 75 100 100 100 50 75 0 0 75 50 75 0 0 0 75 75 75 50 50 50 50 50 50 50 50 50 75 100 100 75 75 50 50 100 100 50 50 50 75 100 100 100 75 75 50 50 50 75
50 50 50 50 50 50 50 75 0 0 75 50 50 75 75 75 75 50 50 50 50 50 50 75 50 50 50 50 50 75 75 75 50 100 100 100 100 50 50 50 100 100 100 75 75 50 50 50 50 50
50 75 100 75 50 50 50 100 0 0 0 75 50 50 50 50 0 50 50 50 50 50 75 100 75 50 50 50 50 50 75 75 50 50 50 50 50 75 50 50 50 50 50 0 0 50 50 50 50 50
50 75 100 75 50 50 100 100 0 0 0 75 50 50 0 0 0 50 50 50 50 100 100 0 100 100 50 75 75 75 75 75 75 50 50 50 75 50 75 0 0 0 0 0 50 50 75 50 50 50
50 75 100 75 50 50 50 100 0 0 0 75 50 50 50 0 0 50 50 50 75 100 0 0 0 100 75 50 75 75 100 100 75 50 50 50 75 50 50 50 50 50 50 50 75 50 50 50 50 50
50 75 100 75 50 50 75 75 0 75 75 50 50 75 0 75 75 75 50 50 50 100 100 0 100 100 50 50 50 100 100 100 50 50 50 50 50 0 0 0 50 50 50 75 50 50 50 50 50 50
50 100 100 100 50 50 50 75 75 75 50 50 75 0 0 0 75 75 75 75 50 50 75 100 75 50 50 50 50 50 100 100 50 50 75 50 50 50 50 0 50 50 50 50 100 100 50 50 50 50
75 50 100 50 50 50 50 50 0 50 50 50 50 75 0 50 50 50 50 50 50 50 50 50 0 0 50 50 50 50 50 50 50 50 50 50 75 50 50 50 50 50 50 100 100 100 50 50 50 50
100 75 50 50 50 50 50 0 0 0 50 50 50 50 50 50 50 50 50 50 50 75 75 75 75 75 50 50 50 50 50 50 50 50 50 50 50 75 50 50 50 50 50 50 50 50 50 50 50 50
100 100 75 75 50 50 50 50 0 50 50 50 75 75 75 75 75 75 75 75 75 75 75 75 75 75 75 50 50 50 50 100 100 50 50 50 0 0 0 0 50 50 75 75 75 75 75 50 50 50
100 100 100 75 75 50 50 50 50 50 50 75 75 75 75 75 100 100 100 100 100 100 100 100 100 100 100 75 50 50 50 50 50 50 50 0 0 0 75 50 50 50 50 50 75 75 75 50 50 50
100 100 100 100 75 75 50 50 50 50 75 75 75 100 100 100 100 100 100 100 100 100 100 100 100 100 100 100 50 50 50 75 75 75 50 50 50 50 50 50 50 75 50 50 50 50 50 50 50 50
25
